16 16

25 27 27 27 27 27 27 27 27 27 27 27 27 27 27 26
25 28 28 28 28 28 28 28 28 28 28 28 28 28 28 26
25 23 23 23 23 23 23 23 23 23 23 23 23 23 23 26
25 23 23 23 23 23 23 23 23 23 23 23 23 23 23 26
25 23 23 23 23 23 23 23 23 23 23 23 23 23 23 26
25 23 23 23 23 23 23 23 23 23 23 23 23 23 23 26
25 23 23 23 23 23 23 23 23 23 23 23 23 23 23 26
25 23 23 23 23 23 23 23 23 23 23 23 23 23 23 26
25 23 23 23 23 23 23 23 23 23 23 23 23 23 23 26
25 23 23 23 23 23 23 23 23 23 23 23 23 23 23 26
25 23 23 23 23 23 23 23 23 23 23 23 23 23 23 26
7 24 24 24 24 24 24 24 24 24 24 24 24 24 24 7
7 7 7 7 7 7 7 7 7 7 7 7 7 7 7 7
7 7 7 7 7 7 7 7 7 7 7 7 7 7 7 7
7 7 7 7 7 7 7 7 7 7 7 7 7 7 7 7
7 7 7 7 7 7 7 7 7 7 7 7 7 7 7 7
