55 55

1 1 1 1 1 1 1 1 1 1 1 1 1 1 1 1 1 1 1 1 1 1 1 1 1 1 1 1 1 1 1 1 1 1 1 1 1 1 1 1 1 1 1 1 1 1 1 1 1 7 7 7 7 7 7
1 4 4 4 4 4 4 4 4 4 4 4 4 4 4 4 4 4 4 4 4 4 4 4 4 4 4 4 4 4 4 4 4 4 4 4 4 4 4 4 4 4 4 4 4 4 4 4 4 7 7 7 7 7 7
6 0 0 0 0 0 0 0 0 14 7 7 15 0 0 0 0 0 0 0 0 0 14 7 15 0 0 0 0 14 7 15 0 0 0 0 14 7 15 0 0 0 0 0 0 0 0 0 0 14 7 7 7 7 7
6 0 0 0 0 0 0 0 0 8 13 13 9 0 0 0 0 0 0 0 0 0 14 7 15 0 0 0 0 14 7 15 0 0 0 0 14 7 15 0 0 0 0 0 0 0 0 0 0 14 7 7 7 7 7
6 0 0 0 0 0 0 0 0 5 1 1 6 0 0 0 0 0 0 0 0 0 14 7 15 0 0 0 0 14 7 15 0 0 0 0 14 7 15 0 0 0 0 10 12 11 0 0 0 14 7 7 7 7 7
6 0 0 0 0 0 0 0 0 2 4 4 3 0 0 0 0 0 0 0 0 0 14 7 15 0 0 0 0 14 7 15 0 0 0 0 14 7 15 0 0 0 0 14 7 15 0 0 0 14 7 7 7 7 7
6 0 0 0 0 0 0 0 0 0 0 0 0 0 0 0 0 0 0 0 0 0 14 7 15 0 0 0 0 14 7 15 0 0 0 0 14 7 15 0 0 0 0 14 7 15 0 0 0 14 7 7 7 7 7
6 0 0 0 10 11 0 0 0 0 0 0 0 0 0 0 0 0 0 0 0 0 14 7 15 0 0 0 0 14 7 15 0 0 0 0 14 7 15 0 0 0 0 14 7 15 0 0 0 14 7 7 7 7 7
6 0 0 0 8 9 0 0 0 0 0 0 0 0 0 0 0 0 0 0 0 0 14 7 15 0 0 0 0 14 7 15 0 0 0 0 14 7 15 0 0 0 0 14 7 15 0 0 0 14 7 7 7 7 7
6 0 0 0 5 6 0 0 0 0 0 0 0 0 0 0 0 0 0 0 0 0 14 7 15 0 0 0 0 14 7 15 0 0 0 0 14 7 15 0 0 0 0 14 7 15 0 0 0 14 7 7 7 7 7
6 0 0 0 2 3 0 0 0 0 0 0 0 0 0 0 0 0 0 0 0 0 14 7 15 0 0 0 0 14 7 15 0 0 0 0 14 7 15 0 0 0 0 14 7 15 0 0 0 14 7 7 7 7 7
6 0 0 0 0 0 0 0 0 0 0 0 0 0 0 0 0 0 0 0 0 0 8 13 9 0 0 0 0 8 13 9 0 0 0 0 8 13 9 0 0 0 0 8 13 9 0 0 0 14 7 7 7 7 7
6 0 0 0 0 0 0 0 0 10 12 12 12 12 12 12 12 11 0 0 0 0 5 1 6 0 0 0 0 5 1 6 0 0 0 0 5 1 6 0 0 0 0 5 1 6 0 0 0 14 7 7 7 7 7
6 0 0 0 0 0 0 0 0 14 7 7 7 7 7 7 7 15 0 0 0 0 2 4 3 0 0 0 0 2 4 3 0 0 0 0 2 4 3 0 0 0 0 2 4 3 0 0 0 14 7 7 7 7 7
6 0 0 0 17 0 0 17 0 8 13 13 13 13 13 13 13 9 0 0 0 0 0 0 0 0 0 0 0 0 0 0 0 0 0 0 0 0 0 0 0 0 0 0 0 0 0 0 0 14 7 7 7 7 7
6 0 17 0 21 0 0 21 0 5 1 1 1 1 1 1 1 6 0 0 0 0 0 0 0 0 0 0 0 0 0 0 0 0 0 0 0 0 0 0 0 0 0 0 0 0 0 0 0 14 7 7 7 7 7
6 0 21 0 21 0 0 21 0 2 4 4 4 4 4 4 4 3 0 0 0 0 0 0 0 0 0 0 0 0 0 0 0 0 0 0 0 0 0 0 0 0 0 0 0 0 0 0 0 14 7 7 7 7 7
6 0 21 0 21 0 0 21 0 0 0 0 0 0 0 0 0 0 0 0 0 0 10 12 11 0 0 0 0 10 12 11 0 0 0 0 10 12 11 0 0 0 0 10 12 11 0 0 0 14 7 7 7 7 7
6 0 21 0 21 0 0 8 22 22 22 22 22 22 22 22 11 0 17 0 17 0 14 7 15 0 0 0 0 14 7 15 0 0 0 0 14 7 15 0 0 0 0 14 7 15 0 0 0 14 7 7 7 7 7
6 0 21 0 21 0 0 0 0 0 0 0 0 0 0 0 21 0 8 22 9 0 14 7 15 0 0 0 0 14 7 15 0 0 0 0 14 7 15 0 0 0 0 14 7 15 0 0 0 14 7 7 7 7 7
6 0 14 22 9 0 0 19 22 22 22 22 22 22 11 0 21 0 0 0 0 0 14 7 15 0 0 0 0 14 7 15 0 0 0 0 14 7 15 0 0 0 0 14 7 15 0 0 0 14 7 7 7 7 7
6 0 21 0 0 0 0 0 0 0 0 0 0 0 21 0 18 0 0 17 0 0 14 7 15 0 0 0 0 14 7 15 0 0 0 0 14 7 15 0 0 0 0 14 7 15 0 0 0 14 7 7 7 7 7
6 0 21 0 0 0 10 22 22 22 22 22 11 0 21 0 0 0 0 18 0 0 14 7 15 0 0 0 0 14 7 15 0 0 0 0 14 7 15 0 0 0 0 14 7 15 0 0 0 14 7 7 7 7 7
6 22 9 0 0 0 21 0 0 0 0 0 21 0 21 0 17 0 0 0 0 0 14 7 15 0 0 0 0 14 7 15 0 0 0 0 14 7 15 0 0 0 0 14 7 15 0 0 0 14 7 7 7 7 7
6 0 0 0 0 0 21 0 19 22 11  0 21 0 21 0 21 0 0 0 0 0 14 7 15 0 0 0 0 14 7 15 0 0 0 0 14 7 15 0 0 0 0 14 7 15 0 0 0 14 7 7 7 7 7
6 0 0 0 0 0 21 0 0 0 21 0 21 0 21 0 21 0 0 17 0 0 14 7 15 0 0 0 0 14 7 15 0 0 0 0 14 7 15 0 0 0 0 14 7 15 0 0 0 14 7 7 7 7 7
6 12 12 12 11 0 21 0 0 0 21 0 21 0 21 0 21 0 0 18 0 0 14 7 15 0 0 0 0 14 7 15 0 0 0 0 14 7 15 0 0 0 0 14 7 15 0 0 0 14 7 7 7 7 7
6 7 7 7 15 0 21 0 19 22 9 0 21 0 21 0 21 0 0 0 0 0 14 7 15 0 0 0 0 14 7 15 0 0 0 0 14 7 15 0 0 0 0 14 7 15 0 0 0 14 7 7 7 7 7
6 7 7 7 15 0 21 0 0 0 0 0 21 0 18 0 21 0 0 0 0 0 14 7 15 0 0 0 0 14 7 15 0 0 0 0 14 7 15 0 0 0 0 14 7 15 0 0 0 14 7 7 7 7 7
6 7 7 7 15 0 21 0 17 0 17 0 18 0 0 0 21 0 0 17 0 0 14 7 15 0 0 0 0 14 7 15 0 0 0 0 14 7 15 0 0 0 0 14 7 15 0 0 0 14 7 7 7 7 7
6 13 13 13 9 0 18 0 21 0 21 0 0 0 0 0 21 0 0 18 0 0 14 7 15 0 0 0 0 14 7 15 0 0 0 0 14 7 15 0 0 0 0 8 13 9 0 0 0 14 7 7 7 7 7
6 0 0 0 0 0 0 0 21 0 21 0 17 0 0 0 21 0 0 0 0 0 14 7 7 12 12 12 12 7 7 7 12 12 12 12 7 7 15 0 0 0 0 5 1 6 0 0 0 14 7 7 7 7 7
6 0 0 0 17 0 0 0 21 0 21 0 14 22 22 12 9 0 0 0 0 0 8 13 13 13 13 13 13 13 13 13 13 13 13 13 13 13 9 0 0 0 0 2 4 3 0 0 0 8 13 13 13 13 13
6 0 0 0 21 0 0 0 21 0 21 0 21 0 0 21 0 0 0 17 0 0 5 1 1 1 1 1 1 1 1 1 1 1 1 1 1 1 6 0 0 0 0 0 0 0 0 0 0 5 1 0 1 1 1
6 0 0 0 14 22 22 22 9 0 21 0 18 0 0 21 0 0 0 21 0 0 2 4 4 4 4 4 4 4 4 4 4 4 4 4 4 4 3 0 0 0 0 0 0 0 0 0 0 2 4 0 4 4 1
6 0 0 0 18 0 0 0 0 0 21 0 0 0 0 21 0 0 0 21 0 0 0 0 0 0 0 0 0 0 0 0 0 0 0 0 0 0 0 0 0 0 0 0 0 0 0 0 0 0 0 0 0 0 5
6 0 0 0 0 0 10 22 22 22 13 22 20 0 0 18 0 0 0 18 0 0 0 0 0 0 0 0 0 0 0 0 0 0 0 0 0 0 0 0 0 0 0 0 0 0 0 0 0 0 0 0 0 0 5
6 0 0 0 0 0 18 0 0 0 0 0 0 0 0 0 0 0 0 0 0 0 10 12 12 12 12 12 12 12 12 12 12 12 12 12 12 12 12 12 12 12 12 12 12 12 12 12 12 12 12 12 12 12 5
6 0 0 0 0 0 0 0 0 0 0 0 0 0 0 0 0 0 0 0 0 0 14 7 7 7 7 7 7 7 7 7 7 7 7 7 7 7 7 7 7 7 7 7 7 7 7 7 7 7 7 7 7 7 5
6 12 12 12 12 12 12 12 12 12 12 12 12 12 12 12 12 12 11 0 0 0 14 7 7 7 7 7 7 7 7 7 7 7 7 7 7 7 7 7 7 7 7 7 7 7 7 7 7 7 7 7 7 7 5
6 7 7 7 7 7 7 7 7 7 7 7 7 7 7 7 7 7 15 0 0 0 14 7 7 7 7 7 7 7 7 7 7 7 7 7 7 7 7 7 7 7 7 7 7 7 7 7 7 7 7 7 7 7 5
6 7 7 7 7 7 7 7 7 7 7 7 7 7 7 7 7 7 15 0 0 0 8 13 13 13 13 13 13 13 13 13 13 13 13 13 13 13 13 13 13 13 13 13 13 13 13 13 13 13 13 13 13 13 5
6 13 13 13 13 13 13 13 13 13 13 13 13 13 13 13 13 13 9 0 0 0 5 1 1 1 1 1 1 1 1 1 1 1 1 1 14 7 15 1 1 1 1 1 1 1 1 1 1 1 1 1 1 1 1
1 1 1 1 1 1 1 1 1 1 1 1 1 1 1 1 1 1 6 0 0 0 2 4 4 4 4 4 4 4 4 4 4 4 4 4 14 7 15 4 4 4 4 4 4 4 4 4 4 4 4 4 4 4 1
1 4 4 4 4 4 4 4 4 4 4 4 4 4 4 4 4 4 3 0 0 0 0 0 0 0 0 0 0 0 0 0 0 0 0 0 14 7 15 0 0 0 0 0 0 0 0 0 0 0 0 0 0 0 5
6 0 0 0 0 0 0 0 0 0 0 0 0 0 0 0 0 0 0 0 0 0 0 0 0 0 0 0 0 0 0 0 0 0 0 0 14 7 15 0 0 0 0 0 0 0 0 0 0 0 0 0 0 0 5
6 0 0 0 0 0 0 0 0 0 0 0 0 0 0 0 0 0 0 0 0 0 10 12 12 11 0 0 0 0 10 12 11 0 0 0 14 7 15 0 0 0 0 0 0 0 0 0 0 0 0 0 0 0 5
6 0 0 0 0 0 0 0 0 0 0 0 0 0 0 0 0 0 0 0 0 0 14 7 7 15 0 0 0 0 14 7 15 0 0 0 14 7 15 0 0 0 10 12 12 11 0 0 0 0 0 0 0 0 5
6 0 0 0 0 0 0 0 0 0 0 0 0 0 0 0 0 0 0 0 0 0 14 7 7 15 0 0 0 0 14 7 15 0 0 0 14 7 15 0 0 0 14 7 7 15 0 0 0 0 0 0 0 0 5
6 0 0 0 0 0 0 0 0 0 0 0 0 0 0 0 0 0 0 0 0 0 8 13 13 9 0 0 0 0 14 7 15 0 0 0 14 7 15 0 0 0 8 13 13 9 0 0 0 0 0 0 0 0 5
6 0 0 0 0 0 0 10 11 0 10 11 0 0 0 0 0 0 0 0 0 0 5 1 1 6 0 0 0 0 14 7 15 0 0 0 8 13 9 0 0 0 5 1 1 6 0 0 0 0 0 0 0 0 5
6 0 0 0 0 0 0 14 15 0 14 15 0 0 0 0 0 0 0 0 0 0 2 4 4 3 0 0 0 0 14 7 15 0 0 0 0 0 0 0 0 0 2 4 4 3 0 0 0 0 0 0 0 0 5
6 0 0 0 0 0 0 14 15 0 14 15 0 0 0 0 0 0 0 0 0 0 0 0 0 0 0 0 0 0 14 7 15 0 0 0 0 0 0 0 0 0 0 0 0 0 0 0 0 0 0 0 0 0 5
6 0 0 0 0 0 0 14 15 0 14 15 0 0 0 0 0 0 0 0 0 0 0 0 0 0 0 0 0 0 14 7 15 0 0 0 0 0 0 0 0 0 0 0 0 0 0 0 0 0 0 0 0 0 5
12 12 12 12 12 12 12 7 7 12 7 7 12 12 12 12 12 12 12 12 12 12 12 12 12 12 12 12 12 12 7 7 7 12 12 12 12 12 12 12 12 12 12 12 12 12 12 12 12 12 12 12 12 12 12

