55 55

6 1 1 1 1 1 1 1 1 1 1 1 1 1 1 1 1 1 1 1 1 1 1 1 1 1 1 1 1 1 1 1 1 1 1 1 1 1 1 1 1 1 1 1 1 1 1 1 1 1 1 1 1 1 5
6 4 4 4 4 4 4 4 4 4 4 4 4  4 4 4 4 4 4 4 4 4 4 4 4 4 4 4 4 4 4 4 4 4 4 4 4 4 4 4 4 4 4 4 4 4 4 4 4 4 4 4 4 4 5
6 0 0 0 0 0 0 0 0 0 0 0 0 0 0 0 0 0 0 0 0 0 0 0 0 0 0 0 0 0 0 0 0 0 0 0 0 0 0 0 0 0 0 0 0 0 0 0 0 0 0 0 0 0 5
6 0 0 0 0 0 0 0 0 0 0 0 0 0 0 0 0 0 0 0 0 0 0 0 0 0 0 0 0 0 0 0 0 0 0 0 0 0 0 0 0 0 0 0 0 0 0 0 0 0 0 0 0 0 5
6 0 0 17 0 0 19 22 22 22 22 22 22 12 22 22 22 22 22 22 12 22 22 22 22 22 22 22 22 22 22 22 20 0 0 19 12 22 22 22 22 22 22 22 22 22 22 22 22 22 22 20 0 0 5
6 0 0 21 0 0 0 0 0 0 0 0 0 21 0 0 0 0 0 0 21 0 0 0 0 0 0 0 0 0 0 0 0 0 0 0 21 0 0 0 0 0 0 0 0 0 0 0 0 0 0 0 0 0 5
6 0 0 21 0 0 0 0 0 0 0 0 0 21 0 0 0 0 0 0 21 0 0 0 0 0 0 10 22 22 22 22 22 22 20 0 21 0 0 0 0 0 0 0 0 0 0 0 0 0 0 0 0 0 5
6 0 0 14 22 22 22 22 12 22 20 0 0 21 0 0 0 0 17 0 8 22 22 22 20 0 0 21 0 0 0 0 0 0 0 0 21 0 0 19 22 22 22 22 22 22 22 22 22 22 22 20 0 0 5
6 0 0 21 0 0 0 0 21 0 0 0 0 21 0 19 11 0 21 0 0 0 0 0 0 0 0 21 0 0 0 0 0 0 0 0 21 0 0 0 0 0 0 0 0 0 0 0 0 0 0 21 0 0 5
6 0 0 21 0 0 0 0 21 0 0 19 22 21 0 0 14 22 12 22 22 22 12 22 22 22 12 22 22 22 12 22 22 22  11 0 14 22 22 22 22 22 22 22 22 22 22 22  11 0 0 21 0 0 5
6 0 0 21 0 0 0 0 18 0 0 0 0 21 0 0 21 0 21 0 0 0 21 0 0 0 21 0 0 0 21 0 0 0 21 0 21 0 0 0 0 0 0 0 0 0 0 0 18 0 0 21 0 0 5
6 0 0 21 0 0 0 0 0 0 0 0 0 21 0 0 21 0 21 0 17 0 21 0 17 0 21 0 17 0 21 0 17 0 21 0 21 0 19 22 22 22 22 22 22 22 17 0 0 0 0 21 0 0 5
6 0 0 21 0 0 10 22 20 0 0 10 22 11 0 0 18 0 18 0 21 0 21 0 21 0 21 0 21 0 21 0 21 0 21 0 21 0 0 0 0 0 0 0 0 0 11 22 22 22 22 21 0 0 5
6 0 0 21 0 0 21 0 0 0 0 21 0 0 0 0 0 0 0 0 17 0 18 0 21 0 21 0 21 0 21 0 21 0 10 22 9 22 22 22 22 22 22 22 11 0 0 0 0 0  0 21 0 0 5
6 0 0 21 0 0 21 0 17 0 0 14 22 22 22 22 22 11 0 0 21 0 0 0 21 0 18 0 21 0 18 0 21 0 0 0 0 0 0 0 0 0  0 0 18 0 10 12 11 0 0 21 0 0 5
6 0 0 21 0 0 21 0 21 0 0 18 0 0 0 0 0 21 0 0 21 0 0 0 21 0 0 0 21 0 0 0 21 0 0 0 0 0 0 0 0 0 0 0 0 0 8 13 9 0 0 21 0 0 5
6 0 0 21 0 10 9 0 21 0 0 0 0 0 0 0 0 21 0 10 13 22 22 22 13 22 22 22 13 22 22 22 13 22 12 22 22 22 22 12 22 22 11 0 0 0 0 0 0 0 0 21 0 0 5
6 0 0 21 0 21 0 0 21 0 0 0 17 0 0 0 0 21 0 21 0 0 0 0 0 0 0 0 0 0 0 0 0 0 21 0 0 0 0 21 0 0 21 0 10 12 22 22 11 0 0 21 0 0 5
6 0 0 21 0 21 0 10 9 0 0 0 14 22 22 20 0 21 0 21 0 10 22 22 22 22 22 22 22 22 22 22 20 0 21 0 17 0 0 21 0 0 21 0 8 15 0 0 21 0 0 21 0 0 5
6 0 0 21 0 18 0 21 0 0 0 0 18 0 0 0 0 21 0 21 0 21 0 0 0 0 0 0 0 0 0 0 0 0 21 0 21 0 0 21 0 0 21 0 0 21 0 0 21 0 0 21 0 0 5
6 0 0 21 0 0 0 21 0 10 11 0 0 0 0 0 0 21 0 21 0 21 0 0 0 0 0 0 0 0 0 0 17 0 21 0 21 0 0 21 0 0 21 0 0 21 0 0 21 0 0 21 0 0 5
6 0 0 21 22 22 22 9 0 8 9 0 0 10 22 22 22 9 0 21 0 21 0 10 22 22 22 22 22 22 11 0 21 0 21 0 21 0 0 21 0 0 21 0 0 21 0 0 21 0 0 21 0 0 5
6 0 0 21 0 0 0 0 0 0 0 0 0 21 0 0 0 0 0 21 0 21 0 21 0 0 0 0 0 0 21 0 21 0 21 0 21 0 0 21 0 0 18 0 0 18 0 0 21 0 0 21 0 0 5
6 0 0 21 0 19 22 22 22 22 22 22 22 9 0 10 22 22 22 15 0 21 0 21 0 0 0 0 0 0 21 0 21 0 21 0 21 0 0 21 0 0 0 0 0 0 0 19 9 0 0 21 0 0 5
6 0 0 21 0 0 0 0 0 0 0 0 0 0 0 21 0 0 0 21 0 21 0 21 0 0 10 11 0 0 21 0 21 0 21 0 21 0 0 21 0 0 0 0 0 0 0 0 0 0 0 21 0 0 5
6 0 0 21 0 0 0 0 0 0 0 0 10 22 22 9 0 0 0 21 0 21 0 21 0 0 8 9 0 0 21 0 21 0 21 0 21 0 0 21 0 0 0 0 0 0 0 19 11 0 0 21 0 0 5
6 0 0 14 22 22 22 12 20 0 10 22 9 0 0 21 0 17 0 21 0 21 0 21 0 0 0 0 0 0 21 0 21 0 21 0 21 0 0 21 0 0 0 0 0 0 0 0 21 0 0 21 0 0 5
6 0 0 21 0 0 0 21 0 0 21 0 0 0 0 21 0 21 0 21 0 21 0 21 0 0 0 0 0 0 21 0 21 0 21 0 21 0 0 21 0 0 17 0 0 17 0 0 21 0 0 21 0 0  5
6 0 0 21 0 0 0 8 22 22 9 0 0 0 0 21 0 21 0 21 0 21 0 8 22 20 0 0  19 22 9 0 21 0 21 0 21 0 0 21 0 0 21 0 0 21 0 0 21  0 0  21 0 0  5
6 0 0 21 0 0 0 0 0 0 0 0 17 0 0 21 0 21 0 21 0 21 0 0 0 0 0 0 0 0 0 0 21 0 21 0 21 0 0 21 0 0 21 0 0  21 0 0 21 0 0 21 0 0  5
6 0 0 21 0 17 0 0 0 0 0 0 21 0 0 21 0 21 0 21 0 8 22 22 22 22 22 12 22 22 22 22 9 0 21 0 21 0 0 21 0 0 21 0 0 21 0 0 21 0 0 21 0 0  5
6 0 0 18 0 21 0 0 0 0 0 0 21 0 0 18 0 21 0 21 0 0 0 0 0 0 0 21 0 0 0 0 0 0 21 0 21 0 0 21 0 0 21 0 0 21 0 0 21 0 0 21 0 0  5
6 0 0 0 0 14 22 22 22 22 22 22 9 0 0 0 0 21 0 21 0 0 0 0 0 17 0 14 22 22 20 0 10 22 9 0 21 0 0 21 0 10 9 0 0 21 0 0 21 0 0 21 0 0  5
6 0 0 0 0 21 0 0 0 0 0 0 0 0 0 0 0 21 0 8 22 12 22 11 0 21 0 21 0 0 0 0 21 0 0 0 21 0 0 21 0 21 0 0 0 21 0 0  21 0 0 21 0 0  5
6 0 0 17 0 21 0 17 0 0 19 22 22 22 22 12 12 15 0 0 0 21 0 18 0 18 0 18 0 10 22 22 9 0 10 22 9 0 0 21 0 21 0 17 0 21 0 0 21 0 0 21 0 0  5
6 0 0 21 0 21 0 21 0 0 0 0 0 0 0 14 7 7 22 20 0 21 0 0 0 0 0 0 0 21 0 0 0 0 21 0 0 0 0 21 0 21 0 21 0 21 0 0 21 0 0 21 0 0  5
6 0 0 21 0 18 0 21 0 0 0 0 0 19 22 13 13 15 0 0 0 21 0 0 0 19 22 22 12 9 0 0 10 22 11 0 0 0 0 21 0 21 0 21 0 18 0 0 21 0 0 21 0 0  5
6 0 0 21 0 0 0 14 22 22 22 20 0 0 0 0 0 21 0 0 0 21 0 0 0 0 0 0 21 0 0 0 21 0 0 0 0 0 0 21 0 21 0 21 0 0 0 0  21 0 0 21 0 0  5
6 0 0 21 0 0 0 21 0 0 0  0 0 10 12 11 0 21 0 17 0 8 22 22 22 22 11 0 21 0 10 22 9 0 0 10 12 12 12 15 0 21 0 21 0 0 0 0 21 0 0 21 0 0  5
6 0 0 14 22 22 22 9 0 0 0 0 0 8 13 15 0 14 12 15 0 0 0 0 0 0 21 0 18 0 21 0 0 0 0 8 13 13 7 15 0 21 0 21 0 0 0 0 21 0 0 21 0 0  5
6 0 0 21 0 0 0 0 0 0 0 0 0 0 0 21 0 8 13 7 12 12 12 12 12 12 15 0 0 0 21 0 0 0 0 0 0 0 14 9 0 21 0 21 0 17 0 0 21 0 0 21 0 0  5
6 0 0 21 0 0 10 12 22 22 22 22 22 22 22 15 0 0 0 8 13 13 13 13 13 13 13 22 22 22 15 0 17 0 19 22 11 0 21 0 0 21 0 21 0 21 0 0 21 0 0 21 0 0  5
6 0 0 21 0 0 8 9 0 0 0 0 0 0 0 21 0 0 0 0 0 0 0 0 0 0 0 0 0 0 8 22 15 0 0 0 21 0 21 0 0 21 0 21 0 21 0 0 21 0 0  21 0 0  5
6 0 0 21 0 0 0 0 0 0 0 0 0 0 0 21 0 0 0 0 0 0 0 0 0 0 0 0 0 0 0 0 14 20 0 0 21 0 21 0 10 9 0 21 0 14 22 22 15 0 0 21 0 0  5
6 0 0 21 0 10 22 22 22 12 11 0 17 0 0 14 22 22 22 22 22 22 22 22 22 22 22 22 12 22 22 22 15 0 0 0 21 0 21 0 21 0 0 21 0 21 0 0 21 0 0  21 0 0  5
6 0 0 21 0 18 0 0 0 8 9 0 21 0 0 21 0 0 0 0 0 0 0 0 0 0 0 0 21 0 0 0 21 0 0 0 21 0 21 0 21 0 10 9 0 21 0 0 21 0 0 21 0 0  5
6 0 0 21 0 0 0 0 0 0 0 0 21 0 0 21 0 0 0 0 10 22 22 12 12 11 0 0 21 0 0 0 18 0 0 0 21 0 21 0 21 0 21 0 0 21 0 0 21 0 0 21 0 0  5
6 0 0 21 0 0 0 0 0 0 0 0 21 0 0 21 0 10 11 0 0 0 0 14 7 15 0 0 21 0 0 0 0 0 0 0 21 0 21 0 21 0 21 0 0 21 0 0 18 0 0 21 0 0  5
6 0 0 21 0 0 0 0 19 22 22 22 13 20 0 8 22 13 13 20 0 0 0 8 7 15 0 0 18 0 0 0 0 19 22 22 9 0 18 0 18 0 18 0 0 18 0 0 0 0 0 18 0 0  5
6 0 0 21 0 0 0 0 0 0 0 0 0 0 0 0 0 0 0 0 0 0 0 0 14 15 0 0 0 0 0 0 0 0 0 0 0 0 0 0 0 0 0 0 0 0 0 0 0 0 0 0 0 0  5
6 0 0 18 0 0 19 22 22 22 22 22 22 22 22 22 22 22 22 22 22 22 22 22 13 13 22 22 22 22 22 22 22 22 22 22 22 22 22 22 22 22 22 22 22 22 22 22 22 22 22 20 0 0  5
6 0 0 0 0 0 0 0 0 0 0 0 0 0 0 0 0 0 0 0 0 0 0 0 0 0 0 0 0 0 0 0 0 0 0 0 0 0 0 0 0 0 0 0 0 0 0 0 0 0 0 0 0 0  5
6 0 0 0 0 0 0 0 0 0 0 0 0 0 0 0 0 0 0 0 0 0 0 0 0 0 0 0 0 0 0 0 0 0 0 0 0 0 0 0 0 0 0 0 0 0 0 0 0 0 0 0 0 0  5
6 0 0 0 0 0 0 0 0 0 0 0 0 0 0 0 0 0 0 0 0 0 0 0 0 0 0 0 0 0 0 0 0 0 0 0 0 0 0 0 0 0 0 0 0 0 0 0 0 0 0 0 0 0  5
6 12 12 12 12 12 12 12 12 12 12 12 12 12 12 12 12 12 12 12 12 12 12 12 12 12 12 12 12 12 12 12 12 12 12 12 12 12 12 12 12 12 12 12 12 12 12 12 12 12 12 12 12 12 5

